NO assets/cyber_wall_north.xpm
SO assets/cyber_wall_south.xpm
WE assets/cyber_wall_west.xpm
EA assets/cyber_wall_east.xpm
DO assets/cyber_door.xpm
F 10,5,20
C 5,5,15

1111111111111111111111111111
1000000000000000000000000001
1000000000000000000000000001
100000001111D1111000000000D1
100000001000000010000000001
100000001020000010000200001
100000001000000010000000001
100000001000D0001000000000D1
100000001000000010000000001
100000001000020010002000001
100000001000000010000000001
100000001111D1111000000000D1
1000000000000000000000000001
1000000000000000000000000001
100D000000000N0000000000D001
1000000000000000000000000001
1000000000000000000000000001
1000020000000000000000020001
1000000000000000000000000001
1000000000000000000000000001
100D000000000000000000000D01
1000000000000000000000000001
1000000000000000000000000001
100000000002000200000000001
1000000000000000000000000001
1000000000000000000000000001
1111111111111111111111111111
