NO assets/cyber_wall_north.xpm
SO assets/cyber_wall_south.xpm
WE assets/cyber_wall_west.xpm
EA assets/cyber_wall_east.xpm
DO assets/cyber_door.xpm
F 10,15,25
C 5,5,15

1111111111111111111111111111111111111111
1000000000000000000000000000000000000001
1020000000000D0000000000000D00000001111
1000000000000000000000000000000000000001
1000001111111111111111111111111110000001
1000001000000000000000000000000010000001
1000001020000000000000000000002010000001
1000001000000000000000000000000010000001
1000001000000111111D11111100000010000001
1000001000000100000000000100000010000001
1000001000000102000000000201000010000001
1000001000000100000000000100000010000001
1000001000000100000N00000100000100000011
1000001000000100000000000100000010000001
1000001000000102000000000201000010000001
1000001000000100000000000100000010000001
1000001000000111111D11111100000010000001
1000001000000000000000000000000010000001
1000001020000000000000000000002010000001
1000001000000000000000000000000010000001
1000001111111111111111111111111110000001
1000000000000000000000000000000000000001
1020000000000D0000000000000D00000001111
1000000000000000000000000000000000000001
1111111111111111111111111111111111111111
