NO minilibx-linux/test/open.xpm
SO minilibx-linux/test/open24.xpm
WE minilibx-linux/test/open30.xpm
EA minilibx-linux/test/open.xpm
F 220,100,0
C 30,144,255

111111
1N0001
111111
