NO a
SO b
WE c
EA d
F 1,2,3
C 4,5,6

1111
1N 1
1111
